10000000000000000000000000000000
10000000200000000000000000000000
10000000000000000000000000000000
10000000000222220000000000000000
10000000000000000000000000000000
10003333000000000000000022222000
10000000000000000000000000000000
10000000000000000222220000000000
10000000000000000000000000000000
10000000002222200000000000000000
10000020000000000000000000000000
11111111111111111111111111111111